7f454c460101010000000000000000000200030001000000508504083400
0000642100000000000034002000090028001e001b000600000034000000
348004083480040820010000200100000500000004000000030000005401
000054810408548104081300000013000000040000000100000001000000
000000000080040800800408ac140000ac14000005000000001000000100
0000141f000014af040814af040828010000580100000600000000100000
02000000281f000028af040828af0408c8000000c8000000060000000400
000004000000680100006881040868810408440000004400000004000000
0400000050e57464cc120000cc920408cc9204085c0000005c0000000400
00000400000051e574640000000000000000000000000000000000000000
060000000400000052e57464141f000014af040814af0408ec000000ec00
000004000000010000002f6c69622f6c642d6c696e75782e736f2e320000
040000001000000001000000474e55000000000002000000060000001800
0000040000001400000003000000474e550041bcce3fb6d2326e75eac775
228132855df1f0ca030000000d0000000100000005000000002302220d00
00000e00000000000000291d8c1c38f28b1cad4be3c00000000000000000
00000000000000003a000000000000000000000012000000290000000000
000000000000120000006200000000000000000000001200000070000000
000000000000000012000000540000000000000000000000120000004f00
000000000000000000001200000001000000000000000000000020000000
770000000000000000000000120000007c00000000000000000000001200
0000480000000000000000000000120000004e0000000000000000000000
12000000690000000000000000000000120000004100000060b004080400
0000110019005b00000040b0040804000000110019001a0000009c8f0408
0400000011000f00005f5f676d6f6e5f73746172745f5f006c6962632e73
6f2e36005f494f5f737464696e5f75736564005f5f737461636b5f63686b
5f6661696c00737472647570007374646f75740066707574630066707574
7300676574656e7600737464657272006765747569640070747261636500
667772697465006f70656e005f5f6c6962635f73746172745f6d61696e00
474c4942435f322e3400474c4942435f322e300000000200030002000200
020002000000020002000200020002000200020001000000010002001000
000010000000000000001469690d000003008e000000100000001069690d
000002009800000000000000f0af04080607000040b00408050e000060b0
0408050d000000b004080701000004b004080702000008b0040807030000
0cb004080704000010b004080705000014b004080706000018b004080707
00001cb004080708000020b004080709000024b00408070a000028b00408
070b00002cb00408070c00005383ec08e8000000005b81c3a72b00008b83
fcffffff85c07405e88d000000e878010000e8e30a000083c4085bc30000
000000000000000000000000ff35f8af0408ff25fcaf040800000000ff25
00b004086800000000e9e0ffffffff2504b004086808000000e9d0ffffff
ff2508b004086810000000e9c0ffffffff250cb004086818000000e9b0ff
ffffff2510b004086820000000e9a0ffffffff2514b004086828000000e9
90ffffffff2518b004086830000000e980ffffffff251cb0040868380000
00e970ffffffff2520b004086840000000e960ffffffff2524b004086848
000000e950ffffffff2528b004086850000000e940ffffffff252cb00408
6858000000e930ffffff31ed5e89e183e4f050545268408f040868d08e04
0851566846890408e89ffffffff490909090909090909090909090905589
e55383ec04803d64b0040800753fa168b00408bb20af040881eb1caf0408
c1fb0283eb0139d8731e8db60000000083c001a368b00408ff14851caf04
08a168b0040839d872e8c60564b004080183c4045b5dc38d7426008dbc27
000000005589e583ec18a124af040885c07412b80000000085c07409c704
2424af0408ffd0c9c3905589e55783ec448b4508890424e87afeffff8945
f4c745e800000000c745e400000000e9bf000000837de8067507c745e800
0000008b45e483e00184c0744cc745ec00000000eb2e8b45e48b55f401d0
0fb61083c20188108b45e48b55f401d00fb6003c7f750b8b45e48b55f401
d0c600208345ec018b45e805a08f04080fb6000fbec03b45ec7fbfeb548b
45e483e00185c0754ac745f000000000eb2e8b45e48b55f401d00fb61083
ea0188108b45e48b55f401d00fb6003c1f750b8b45e48b55f401d0c6007e
8345f0018b45e805a08f04080fb6000fbec03b45f07fbf8345e4018345e8
018b45f4c745d4ffffffff89c2b8000000008b4dd489d7f2ae89c8f7d083
e8013b45e40f8719ffffff8b45f483c4445f5dc35589e5565383ec10c745
f4ffffffffb8050000008b5d088b4d0cba00000000cd8089c68975f48b45
f483c4105b5e5dc35589e5565383ec10c745f000000000eb3e8b45f08b55
088d3402b8030000008b5d1089f1ba01000000cd8089c68975f4837df401
75268b45f08b550801d00fb6003c0a75068345f001eb128345f0018b450c
83e8013b45f077b7eb01908b45f08b550801d0c600008b45f083c4105b5e
5dc35589e583ec10c745f8000000008b45088945fceb4ec745f801000000
c745f400000000eb218b45f403450c0fb6108b45f40345fc0fb60038c274
07c745f8000000008345f401837df801750d8b45f403450c0fb60084c075
cc837df80174108345fc018b45fc0fb60084c075a8eb0190837df8007507
b800000000eb068b45f40345fcc9c35589e583ec188b450c894424048b45
08890424e863ffffff8945fc837dfc00750ab800000000e9d60000008b45
fc0fb6003c2d740ab800000000e9c2000000c745f8000000008345fc01eb
0bc745f8010000008345fc018b45fc0fb6003c2f7e0a8b45fc0fb6003c39
7ee1837df800740a8b45fc0fb6003c2e7407b800000000eb7fc745f80000
00008345fc01eb0bc745f8010000008345fc018b45fc0fb6003c2f7e0a8b
45fc0fb6003c397ee1837df8007507b800000000eb46c745f400000000eb
268b1538b004088b45f401d00fb6108b45f40345fc0fb60038c27407b800
000000eb1b8345f4018b1538b004088b45f401d00fb60084c075c8b80100
0000c9c35589e55383e4f081ec2001000065a1140000008984241c010000
31c0c744241000000000c744240c00000000c744240801000000c7442404
00000000c7042400000000e8b2fbffff85c07916c70424a88f0408e842fb
ffffb801000000e90a050000c70424c48f0408e81cfbffff85c07432a140
b0040889c2b8d08f04088954240cc744240825000000c744240401000000
890424e8e0faffffb801000000e9c8040000c744240400000000c70424f6
8f0408e802fbffff85c07e32a140b0040889c2b8d08f04088954240cc744
240825000000c744240401000000890424e896faffffb801000000e97e04
0000c744240400000000c7042409900408e8d4fcffff89442414837c2414
ff0f8531040000a140b0040889c2b81c9004088954240cc7442408460000
00c744240401000000890424e841faffffb801000000e929040000c74424
04639004088d44241c890424e8a6fdffff85c0740dc744241001000000e9
db030000837c2410000f84d0030000c7442404689004088d44241c890424
e876fdffff85c00f8471030000a160b0040889c2b86c9004088954240cc7
44240820000000c744240401000000890424e8c3f9ffffe8aef9ffff8944
24188b4424183dbe0b00000f84b60100003dd0070000774c3dba0b00000f
84140100003dba0b0000771f3db80b00000f84ba0000003db80b00000f87
d300000085c0747ee9b90200003dbc0b00000f842b0100003dbc0b00000f
8744010000e9f70000003dc20b00000f84e80100003dd0070000771b3dc0
0b00000f848e0100003dc00b00000f87a7010000e95a0100003dc40b0000
0f84030200003dd00700000f82d40100003dc50b00000f840e0200003dde
0700000f8424020000e940020000a160b0040889c2b8909004088954240c
c744240821000000c744240401000000890424e8d2f8ffffe93c020000a1
60b0040889c3c70424b2900408e8fef9ffff895c2404890424e81ef9ffff
e918020000a160b0040889c3c70424cc900408e8daf9ffff895c24048904
24e8faf8ffffe9f4010000a160b0040889c3c70424e6900408e8b6f9ffff
895c2404890424e8d6f8ffffe9d0010000a160b0040889c3c70424009104
08e892f9ffff895c2404890424e8b2f8ffffe9ac010000a160b0040889c3
c704241a910408e86ef9ffff895c2404890424e88ef8ffffe988010000a1
60b0040889c3c7042434910408e84af9ffff895c2404890424e86af8ffff
e964010000a160b0040889c3c704244e910408e826f9ffff895c24048904
24e846f8ffffe940010000a160b0040889c3c7042468910408e802f9ffff
895c2404890424e822f8ffffe91c010000a160b0040889c3c70424829104
08e8def8ffff895c2404890424e8fef7ffffe9f8000000a160b0040889c3
c704249c910408e8baf8ffff895c2404890424e8daf7ffffe9d4000000a1
60b0040889c3c70424b6910408e896f8ffff895c2404890424e8b6f7ffff
e9b0000000a160b0040889c3c70424d0910408e872f8ffff895c24048904
24e892f7ffffe98c000000a160b0040889c3c70424ea910408e84ef8ffff
895c2404890424e86ef7ffffeb6ba160b0040889c3c7042404920408e82d
f8ffff895c2404890424e84df7ffffeb4aa160b0040889c3c70424209204
08e80cf8ffff895c2404890424e82cf7ffffeb29a160b0040889c2b84892
04088954240cc744240838000000c744240401000000890424e892f6ffff
90a160b0040889442404c704240a000000e8dcf6ffffeb67c74424048192
04088d44241c890424e864f9ffff85c0752ba140b0040889c2b894920408
8954240cc744240830000000c744240401000000890424e83af6ffffeb25
908b44241489442408c7442404000100008d44241c890424e8a7f8ffff85
c00f85dcfbffffb8000000008b94241c010000653315140000007405e8d9
f5ffff8b5dfcc9c39090909055575653e86900000081c31b21000083ec1c
8b6c24308dbb20ffffffe853f5ffff8d8320ffffff29c7c1ff0285ff7429
31f68db6000000008b442438892c24894424088b44243489442404ff94b3
20ffffff83c60139fe75df83c41c5b5e5f5dc3eb0d909090909090909090
90909090f3c38b1c24c3909090909090909090905589e55383ec04a114af
040883f8ff7413bb14af0408669083eb04ffd08b0383f8ff75f483c4045b
5dc390905383ec08e8000000005b81c36f200000e8eff5ffff83c4085bc3
000003000000010002003031323334353600596f752073686f756c64206e
6f7420726576657273652074686973004c445f5052454c4f41440000496e
6a656374696f6e204c696e6b6564206c6962206465746563746564206578
69742e2e0a002f6574632f6c642e736f2e7072656c6f6164002f70726f63
2f73656c662f6d617073000000002f70726f632f73656c662f6d61707320
697320756e61636365737369626c652c2070726f6261626c792061204c44
5f5052454c4f414420617474656d707420657869742e2e0a006c69626300
6c640000436865636b20666c61672e4865726520697320796f757220746f
6b656e203a2000000000596f752061726520726f6f742061726520796f75
20746861742064756d62203f0a00496066413e5f38386545643a3d603835
6830443848453e2c44003760344369343d5e643d4a2c3f3e693b362c3764
3431362c37003c3e4231365c41443c43362c475f3c313e5e3763693e6c34
42004238623a362c33666a373a2c3b62683e44403e38693a364044003f34
64403a2c433e38433630473e383a683a4762343f6c2c41004738482e362c
3d346b354a303c63642f44403e3e423a3e3a340048384238685f32304234
4a34333e3c383e5c45443c3b6a4033003738483a4a343c343c39695f4934
6b304a5e353e42316a603900626369606d437b296a786b6e3c2275447e36
256737464b6037004463366d7e3b7d6638436a2378466b656c3b23267963
66624b0037344839445e336564376b30353434354a304534653b44613400
37306843692c45343444665b4134422f4a4033663c3d3a604400385f4477
2234233f2b33695d71263b7036206774773838454300626f655d21616930
4642402e3a7c4c366c40413f3e714a7d4900000067203c7436313a7c345f
7c214049462e2d3632464826477e44434b2f456b72767664777a3f767c00
0a4e6f7065207468657265206973206e6f20746f6b656e20686572652066
6f7220796f7520736f7272792e2054727920616761696e203a2900303030
30303030302030303a303020300000004c445f5052454c4f414420646574
6563746564207468726f756768206d656d6f7279206d6170732065786974
202e2e0a002e736f0a000000011b033b580000000a000000b4f1ffff7400
000038f3ffff9800000050f4ffffc000000080f4ffffe8000000f2f4ffff
1001000077f5ffff300100007af6ffff5001000004fcffff7801000074fc
ffffb401000076fcffffc80100001400000000000000017a5200017c0801
1b0c040488010000200000001c00000038f1ffffd0000000000e08460e0c
4a0f0b740478003f1a3b2a322422240000004000000098f2ffff18010000
00410e088502420d054a8703030901c7410c0404c5000000240000006800
000088f3ffff3000000000410e088502420d054c830486035ec341c6410c
0404c500240000009000000090f3ffff7200000000410e088502420d054e
83048603025ec341c6410c0404c51c000000b8000000daf3ffff85000000
00410e088502420d050281c50c0404001c000000d80000003ff4ffff0301
000000410e088502420d0502ffc50c04040024000000f800000022f5ffff
8605000000410e088502420d0502408303034205c50c0404c30000003800
00002001000084faffff6100000000410e088502410e0c8703410e108604
410e1483054e0e30024a0e14410e10c3410e0cc6410e08c7410e04c51000
00005c010000b8faffff02000000000000001000000070010000a6faffff
040000000000000000000000000000000000000000000000000000000000
000000000000000000000000000000000000000000000000000000000000
000000000000000000000000000000000000000000000000000000000000
000000000000000000000000000000000000000000000000000000000000
000000000000000000000000000000000000000000000000000000000000
000000000000000000000000000000000000000000000000000000000000
000000000000000000000000000000000000000000000000000000000000
000000000000000000000000000000000000000000000000000000000000
000000000000000000000000000000000000000000000000000000000000
000000000000000000000000000000000000000000000000000000000000
000000000000000000000000000000000000000000000000000000000000
000000000000000000000000000000000000000000000000000000000000
000000000000000000000000000000000000000000000000000000000000
000000000000000000000000000000000000000000000000000000000000
000000000000000000000000000000000000000000000000000000000000
000000000000000000000000000000000000000000000000000000000000
000000000000000000000000000000000000000000000000000000000000
000000000000000000000000000000000000000000000000000000000000
000000000000000000000000000000000000000000000000000000000000
000000000000000000000000000000000000000000000000000000000000
000000000000000000000000000000000000000000000000000000000000
000000000000000000000000000000000000000000000000000000000000
000000000000000000000000000000000000000000000000000000000000
000000000000000000000000000000000000000000000000000000000000
000000000000000000000000000000000000000000000000000000000000
000000000000000000000000000000000000000000000000000000000000
000000000000000000000000000000000000000000000000000000000000
000000000000000000000000000000000000000000000000000000000000
000000000000000000000000000000000000000000000000000000000000
000000000000000000000000000000000000000000000000000000000000
000000000000000000000000000000000000000000000000000000000000
000000000000000000000000000000000000000000000000000000000000
000000000000000000000000000000000000000000000000000000000000
000000000000000000000000000000000000000000000000000000000000
000000000000000000000000000000000000000000000000000000000000
000000000000000000000000000000000000000000000000000000000000
000000000000000000000000000000000000000000000000000000000000
000000000000000000000000000000000000000000000000000000000000
000000000000000000000000000000000000000000000000000000000000
000000000000000000000000000000000000000000000000000000000000
000000000000000000000000000000000000000000000000000000000000
000000000000000000000000000000000000000000000000000000000000
000000000000000000000000000000000000000000000000000000000000
000000000000000000000000000000000000000000000000000000000000
000000000000000000000000000000000000000000000000000000000000
000000000000000000000000000000000000000000000000000000000000
000000000000000000000000000000000000000000000000000000000000
000000000000000000000000000000000000000000000000000000000000
000000000000000000000000000000000000000000000000000000000000
000000000000000000000000000000000000000000000000000000000000
000000000000000000000000000000000000000000000000000000000000
000000000000000000000000000000000000000000000000000000000000
000000000000000000000000000000000000000000000000000000000000
000000000000000000000000000000000000000000000000000000000000
000000000000000000000000000000000000000000000000000000000000
000000000000000000000000000000000000000000000000000000000000
000000000000000000000000000000000000000000000000000000000000
000000000000000000000000000000000000000000000000000000000000
000000000000000000000000000000000000000000000000000000000000
000000000000000000000000000000000000000000000000000000000000
000000000000000000000000000000000000000000000000000000000000
000000000000000000000000000000000000000000000000000000000000
000000000000000000000000000000000000000000000000000000000000
000000000000000000000000000000000000000000000000000000000000
000000000000000000000000000000000000000000000000000000000000
000000000000000000000000000000000000000000000000000000000000
000000000000000000000000000000000000000000000000000000000000
000000000000000000000000000000000000000000000000000000000000
000000000000000000000000000000000000000000000000000000000000
000000000000000000000000000000000000000000000000000000000000
000000000000000000000000000000000000000000000000000000000000
000000000000000000000000000000000000000000000000000000000000
000000000000000000000000000000000000000000000000000000000000
000000000000000000000000000000000000000000000000000000000000
000000000000000000000000000000000000000000000000000000000000
000000000000000000000000000000000000000000000000000000000000
000000000000000000000000000000000000000000000000000000000000
000000000000000000000000000000000000000000000000000000000000
000000000000000000000000000000000000000000000000000000000000
000000000000000000000000000000000000000000000000000000000000
000000000000000000000000000000000000000000000000000000000000
000000000000000000000000000000000000000000000000000000000000
000000000000000000000000000000000000000000000000000000000000
000000000000000000000000000000000000000000000000000000000000
000000000000000000000000000000000000000000000000000000000000
000000000000000000000000000000000000000000000000000000000000
000000000000000000000000000000000000000000000000000000000000
000000000000000000000000000000000000000000000000000000000000
000000000000000000000000000000000000000000000000000000000000
000000000000ffffffff00000000ffffffff000000000000000001000000
100000000c000000448404080d0000007c8f0408f5feff6fac8104080500
0000d882040806000000d88104080a000000a20000000b00000010000000
150000000000000003000000f4af04080200000060000000140000001100
000017000000e483040811000000cc830408120000001800000013000000
08000000feffff6f9c830408ffffff6f01000000f0ffff6f7a8304080000
000000000000000000000000000000000000000000000000000000000000
000000000000000000000000000000000000000028af0408000000000000
000096840408a6840408b6840408c6840408d6840408e6840408f6840408
06850408168504082685040836850408468504080000000000000000c592
04084743433a20285562756e74752f4c696e61726f20342e362e332d3175
62756e7475352920342e362e3300002e73796d746162002e737472746162
002e7368737472746162002e696e74657270002e6e6f74652e4142492d74
6167002e6e6f74652e676e752e6275696c642d6964002e676e752e686173
68002e64796e73796d002e64796e737472002e676e752e76657273696f6e
002e676e752e76657273696f6e5f72002e72656c2e64796e002e72656c2e
706c74002e696e6974002e74657874002e66696e69002e726f6461746100
2e65685f6672616d655f686472002e65685f6672616d65002e63746f7273
002e64746f7273002e6a6372002e64796e616d6963002e676f74002e676f
742e706c74002e64617461002e627373002e636f6d6d656e740000000000
000000000000000000000000000000000000000000000000000000000000
00000000000000001b000000010000000200000054810408540100001300
000000000000000000000100000000000000230000000700000002000000
688104086801000020000000000000000000000004000000000000003100
000007000000020000008881040888010000240000000000000000000000
040000000000000044000000f6ffff6f02000000ac810408ac0100002c00
0000050000000000000004000000040000004e0000000b00000002000000
d8810408d801000000010000060000000100000004000000100000005600
00000300000002000000d8820408d8020000a20000000000000000000000
01000000000000005e000000ffffff6f020000007a8304087a0300002000
0000050000000000000002000000020000006b000000feffff6f02000000
9c8304089c03000030000000060000000100000004000000000000007a00
00000900000002000000cc830408cc030000180000000500000000000000
0400000008000000830000000900000002000000e4830408e40300006000
0000050000000c00000004000000080000008c0000000100000006000000
44840408440400002e000000000000000000000004000000000000008700
000001000000060000008084040880040000d00000000000000000000000
100000000400000092000000010000000600000050850408500500002c0a
000000000000000000001000000000000000980000000100000006000000
7c8f04087c0f00001a000000000000000000000004000000000000009e00
00000100000002000000988f0408980f0000320300000000000000000000
0400000000000000a60000000100000002000000cc920408cc1200005c00
000000000000000000000400000000000000b40000000100000002000000
28930408281300008401000000000000000000000400000000000000be00
0000010000000300000014af0408141f0000080000000000000000000000
0400000000000000c500000001000000030000001caf04081c1f00000800
000000000000000000000400000000000000cc0000000100000003000000
24af0408241f00000400000000000000000000000400000000000000d100
0000060000000300000028af0408281f0000c80000000600000000000000
0400000008000000da0000000100000003000000f0af0408f01f00000400
000000000000000000000400000004000000df0000000100000003000000
f4af0408f41f00003c00000000000000000000000400000004000000e800
0000010000000300000030b00408302000000c0000000000000000000000
0400000000000000ee000000080000000300000040b004083c2000002c00
000000000000000000002000000000000000f30000000100000030000000
000000003c2000002a000000000000000000000001000000010000001100
000003000000000000000000000066200000fc0000000000000000000000
010000000000000001000000020000000000000000000000142600002005
00001d0000002e0000000400000010000000090000000300000000000000
00000000342b000005030000000000000000000001000000000000000000
000000000000000000000000000000000000548104080000000003000100
000000006881040800000000030002000000000088810408000000000300
030000000000ac810408000000000300040000000000d881040800000000
0300050000000000d88204080000000003000600000000007a8304080000
000003000700000000009c830408000000000300080000000000cc830408
000000000300090000000000e48304080000000003000a00000000004484
04080000000003000b0000000000808404080000000003000c0000000000
508504080000000003000d00000000007c8f04080000000003000e000000
0000988f04080000000003000f0000000000cc9204080000000003001000
000000002893040800000000030011000000000014af0408000000000300
1200000000001caf040800000000030013000000000024af040800000000
030014000000000028af0408000000000300150000000000f0af04080000
00000300160000000000f4af040800000000030017000000000030b00408
00000000030018000000000040b004080000000003001900000000000000
00000000000003001a000100000000000000000000000400f1ff0c000000
14af040800000000010012001a0000001caf040800000000010013002800
000024af0408000000000100140035000000808504080000000002000d00
4b00000064b0040801000000010019005a00000068b00408040000000100
190068000000e08504080000000002000d00010000000000000000000000
0400f1ff7400000018af0408000000000100120081000000a89404080000
0000010011008f00000024af040800000000010014009b000000508f0408
0000000002000d00b100000000000000000000000400f1ffbb00000038b0
04080400000001001800c400000014af04080000000000001200d5000000
28af04080000000001001500de00000014af04080000000000001200f100
0000f4af0408000000000100170007010000408f04080200000012000d00
170100004c8704087200000012000d0024010000428f0408000000001202
0d003b01000030b004080000000020001800460100000486040818010000
12000d004d01000040b0040804000000110019005f010000000000000000
000012000000710100003cb00408000000001000f1ff780100007c8f0408
0000000012000e007e0100000000000000000000120000009a0100000000
00000000000012000000ac010000000000000000000012000000be010000
20af04080000000011021300cb010000000000000000000012000000dd01
000030b004080000000010001800ea0100001c8704083000000012000d00
f70100000000000000000000120000000702000000000000000000002000
00001602000034b004080000000011021800230200000000000000000000
12000000330200009c8f04080400000011000f0042020000000000000000
0000120000005f020000d08e04086100000012000d006f0200006cb00408
000000001000f1ff74020000508504080000000012000d007b020000988f
04080400000011000f008202000060b00408040000001100190094020000
3cb00408000000001000f1ffa0020000468904088605000012000d00a502
0000000000000000000012000000b6020000be8704088500000012000d00
c2020000000000000000000020000000d602000043880408030100001200
0d00dc020000000000000000000012000000ed0200004484040800000000
12000b00f30200000000000000000000120000000063727473747566662e
63005f5f43544f525f4c4953545f5f005f5f44544f525f4c4953545f5f00
5f5f4a43525f4c4953545f5f005f5f646f5f676c6f62616c5f64746f7273
5f61757800636f6d706c657465642e363135390064746f725f6964782e36
313631006672616d655f64756d6d79005f5f43544f525f454e445f5f005f
5f4652414d455f454e445f5f005f5f4a43525f454e445f5f005f5f646f5f
676c6f62616c5f63746f72735f61757800676574666c61672e6300656e64
2e33313837005f5f696e69745f61727261795f656e64005f44594e414d49
43005f5f696e69745f61727261795f7374617274005f474c4f42414c5f4f
46465345545f5441424c455f005f5f6c6962635f6373755f66696e690073
797363616c6c5f67657473005f5f693638362e6765745f70635f7468756e
6b2e627800646174615f73746172740066745f6465730073746465727240
40474c4942435f322e30007374726475704040474c4942435f322e30005f
6564617461005f66696e69005f5f737461636b5f63686b5f6661696c4040
474c4942435f322e34006765747569644040474c4942435f322e30006677
726974654040474c4942435f322e30005f5f44544f525f454e445f5f0067
6574656e764040474c4942435f322e30005f5f646174615f737461727400
73797363616c6c5f6f70656e00707574734040474c4942435f322e30005f
5f676d6f6e5f73746172745f5f005f5f64736f5f68616e646c65006f7065
6e4040474c4942435f322e30005f494f5f737464696e5f75736564005f5f
6c6962635f73746172745f6d61696e4040474c4942435f322e30005f5f6c
6962635f6373755f696e6974005f656e64005f7374617274005f66705f68
77007374646f75744040474c4942435f322e30005f5f6273735f73746172
74006d61696e0066707574634040474c4942435f322e3000616674657253
7562737472005f4a765f5265676973746572436c61737365730069734c69
620066707574734040474c4942435f322e30005f696e6974007074726163
654040474c4942435f322e3000
