7f454c460101010000000000000000000200030001000000c08304083400
0000481100000000000034002000090028001e001b000600000034000000
348004083480040820010000200100000500000004000000030000005401
000054810408548104081300000013000000040000000100000001000000
000000000080040800800408440800004408000005000000001000000100
0000140f0000149f0408149f04080c010000140100000600000000100000
02000000280f0000289f0408289f0408c8000000c8000000060000000400
000004000000680100006881040868810408440000004400000004000000
0400000050e574641c0700001c8704081c8704083c0000003c0000000400
00000400000051e574640000000000000000000000000000000000000000
060000000400000052e57464140f0000149f0408149f0408ec000000ec00
000004000000010000002f6c69622f6c642d6c696e75782e736f2e320000
040000001000000001000000474e55000000000002000000060000001800
0000040000001400000003000000474e5500bfcf91de3266ca702f12e4d7
5d981082058677ea02000000070000000100000005000000002000200000
000007000000ad4be3c00000000000000000000000000000000035000000
0000000000000000120000002e0000000000000000000000120000003c00
000000000000000000001200000001000000000000000000000020000000
290000000000000000000000120000004300000000000000000000001200
00001a000000bc8604080400000011000f00005f5f676d6f6e5f73746172
745f5f006c6962632e736f2e36005f494f5f737464696e5f757365640065
78697400737472647570007072696e746600676574756964005f5f6c6962
635f73746172745f6d61696e00474c4942435f322e300000000002000200
02000000020002000100010001001000000010000000000000001069690d
000002005500000000000000f09f04080604000000a004080701000004a0
04080702000008a00408070300000ca004080704000010a0040807050000
14a00408070600005383ec08e8000000005b81c3d71c00008b83fcffffff
85c07405e85d000000e818010000e83303000083c4085bc3000000000000
0000000000000000ff35f89f0408ff25fc9f040800000000ff2500a00408
6800000000e9e0ffffffff2504a004086808000000e9d0ffffffff2508a0
04086810000000e9c0ffffffff250ca004086818000000e9b0ffffffff25
10a004086820000000e9a0ffffffff2514a004086828000000e990ffffff
31ed5e89e183e4f0505452686086040868f08504085156688c850408e8cf
fffffff490909090909090909090909090905589e55383ec04803d20a004
0800753fa124a00408bb209f040881eb1c9f0408c1fb0283eb0139d8731e
8db60000000083c001a324a00408ff14851c9f0408a124a0040839d872e8
c60520a004080183c4045b5dc38d7426008dbc27000000005589e583ec18
a1249f040885c07412b80000000085c07409c70424249f0408ffd0c9c390
5589e55783ec448b4508890424e8eafeffff8945f4c745e800000000c745
e400000000e9bf000000837de8067507c745e8000000008b45e483e00184
c0744cc745ec00000000eb2e8b45e48b55f401d00fb61083c20188108b45
e48b55f401d00fb6003c7f750b8b45e48b55f401d0c600208345ec018b45
e805c08604080fb6000fbec03b45ec7fbfeb548b45e483e00185c0754ac7
45f000000000eb2e8b45e48b55f401d00fb61083ea0188108b45e48b55f4
01d00fb6003c1f750b8b45e48b55f401d0c6007e8345f0018b45e805c086
04080fb6000fbec03b45f07fbf8345e4018345e8018b45f4c745d4ffffff
ff89c2b8000000008b4dd489d7f2ae89c8f7d083e8013b45e40f8719ffff
ff8b45f483c4445f5dc35589e583e4f083ec10e8e6fdffff3ddd07000074
2ae8dafdffffbac8860408c74424089210000089442404891424e8a1fdff
ffc7042401000000e8d5fdffffc70424ef860408e89dfeffffba09870408
89442404891424e878fdffffc9c390909090909055575653e86900000081
c3fb19000083ec1c8b6c24308dbb20ffffffe803fdffff8d8320ffffff29
c7c1ff0285ff742931f68db6000000008b442438892c24894424088b4424
3489442404ff94b320ffffff83c60139fe75df83c41c5b5e5f5dc3eb0d90
909090909090909090909090f3c38b1c24c3909090909090909090905589
e55383ec04a1149f040883f8ff7413bb149f0408669083eb04ffd08b0383
f8ff75f483c4045b5dc390905383ec08e8000000005b81c34f190000e83f
fdffff83c4085bc300000300000001000200303132333435360055494420
256420737461727465642075732062757420776520776520657870656374
2025640a00626f655d216169304642402e3a7c4c366c40413f3e714a7d49
00796f757220746f6b656e2069732025730a0000011b033b380000000600
000034fcffff5400000058fdffff7800000070feffffa0000000d4feffff
c000000044fffffffc00000046ffffff100100001400000000000000017a
5200017c08011b0c040488010000200000001c000000d8fbffff70000000
000e08460e0c4a0f0b740478003f1a3b2a3224222400000040000000d8fc
ffff1801000000410e088502420d054a8703030901c7410c0404c5000000
1c00000068000000c8fdffff5e00000000410e088502420d05025ac50c04
040038000000880000000cfeffff6100000000410e088502410e0c870341
0e108604410e1483054e0e30024a0e14410e10c3410e0cc6410e08c7410e
04c510000000c400000040feffff020000000000000010000000d8000000
2efeffff0400000000000000000000000000000000000000000000000000
000000000000000000000000000000000000000000000000000000000000
000000000000000000000000000000000000000000000000000000000000
000000000000000000000000000000000000000000000000000000000000
000000000000000000000000000000000000000000000000000000000000
000000000000000000000000000000000000000000000000000000000000
000000000000000000000000000000000000000000000000000000000000
000000000000000000000000000000000000000000000000000000000000
000000000000000000000000000000000000000000000000000000000000
000000000000000000000000000000000000000000000000000000000000
000000000000000000000000000000000000000000000000000000000000
000000000000000000000000000000000000000000000000000000000000
000000000000000000000000000000000000000000000000000000000000
000000000000000000000000000000000000000000000000000000000000
000000000000000000000000000000000000000000000000000000000000
000000000000000000000000000000000000000000000000000000000000
000000000000000000000000000000000000000000000000000000000000
000000000000000000000000000000000000000000000000000000000000
000000000000000000000000000000000000000000000000000000000000
000000000000000000000000000000000000000000000000000000000000
000000000000000000000000000000000000000000000000000000000000
000000000000000000000000000000000000000000000000000000000000
000000000000000000000000000000000000000000000000000000000000
000000000000000000000000000000000000000000000000000000000000
000000000000000000000000000000000000000000000000000000000000
000000000000000000000000000000000000000000000000000000000000
000000000000000000000000000000000000000000000000000000000000
000000000000000000000000000000000000000000000000000000000000
000000000000000000000000000000000000000000000000000000000000
000000000000000000000000000000000000000000000000000000000000
000000000000000000000000000000000000000000000000000000000000
000000000000000000000000000000000000000000000000000000000000
000000000000000000000000000000000000000000000000000000000000
000000000000000000000000000000000000000000000000000000000000
000000000000000000000000000000000000000000000000000000000000
000000000000000000000000000000000000000000000000000000000000
000000000000000000000000000000000000000000000000000000000000
000000000000000000000000000000000000000000000000000000000000
000000000000000000000000000000000000000000000000000000000000
000000000000000000000000000000000000000000000000000000000000
000000000000000000000000000000000000000000000000000000000000
000000000000000000000000000000000000000000000000000000000000
000000000000000000000000000000000000000000000000000000000000
000000000000000000000000000000000000000000000000000000000000
000000000000000000000000000000000000000000000000000000000000
000000000000000000000000000000000000000000000000000000000000
000000000000000000000000000000000000000000000000000000000000
000000000000000000000000000000000000000000000000000000000000
000000000000000000000000000000000000000000000000000000000000
000000000000000000000000000000000000000000000000000000000000
000000000000000000000000000000000000000000000000000000000000
000000000000000000000000000000000000000000000000000000000000
000000000000000000000000000000000000000000000000000000000000
000000000000000000000000000000000000000000000000000000000000
000000000000000000000000000000000000000000000000000000000000
000000000000000000000000000000000000000000000000000000000000
000000000000000000000000000000000000000000000000000000000000
000000000000000000000000000000000000000000000000000000000000
0000000000000000000000000000000000000000ffffffff00000000ffff
ffff000000000000000001000000100000000c000000148304080d000000
9c860408f5feff6fac810408050000004c82040806000000cc8104080a00
00005f0000000b00000010000000150000000000000003000000f49f0408
0200000030000000140000001100000017000000e482040811000000dc82
040812000000080000001300000008000000feffff6fbc820408ffffff6f
01000000f0ffff6fac820408000000000000000000000000000000000000
000000000000000000000000000000000000000000000000000000000000
00000000289f040800000000000000006683040876830408868304089683
0408a6830408b683040800000000000000004743433a20285562756e7475
2f4c696e61726f20342e362e332d317562756e7475352920342e362e3300
002e73796d746162002e737472746162002e7368737472746162002e696e
74657270002e6e6f74652e4142492d746167002e6e6f74652e676e752e62
75696c642d6964002e676e752e68617368002e64796e73796d002e64796e
737472002e676e752e76657273696f6e002e676e752e76657273696f6e5f
72002e72656c2e64796e002e72656c2e706c74002e696e6974002e746578
74002e66696e69002e726f64617461002e65685f6672616d655f68647200
2e65685f6672616d65002e63746f7273002e64746f7273002e6a6372002e
64796e616d6963002e676f74002e676f742e706c74002e64617461002e62
7373002e636f6d6d656e7400000000000000000000000000000000000000
0000000000000000000000000000000000000000000000001b0000000100
000002000000548104085401000013000000000000000000000001000000
000000002300000007000000020000006881040868010000200000000000
000000000000040000000000000031000000070000000200000088810408
88010000240000000000000000000000040000000000000044000000f6ff
ff6f02000000ac810408ac01000020000000050000000000000004000000
040000004e0000000b00000002000000cc810408cc010000800000000600
00000100000004000000100000005600000003000000020000004c820408
4c0200005f000000000000000000000001000000000000005e000000ffff
ff6f02000000ac820408ac02000010000000050000000000000002000000
020000006b000000feffff6f02000000bc820408bc020000200000000600
00000100000004000000000000007a0000000900000002000000dc820408
dc0200000800000005000000000000000400000008000000830000000900
000002000000e4820408e402000030000000050000000c00000004000000
080000008c000000010000000600000014830408140300002e0000000000
000000000000040000000000000087000000010000000600000050830408
500300007000000000000000000000001000000004000000920000000100
000006000000c0830408c0030000dc020000000000000000000010000000
000000009800000001000000060000009c8604089c0600001a0000000000
00000000000004000000000000009e0000000100000002000000b8860408
b80600006300000000000000000000000400000000000000a60000000100
0000020000001c8704081c0700003c000000000000000000000004000000
00000000b400000001000000020000005887040858070000ec0000000000
0000000000000400000000000000be0000000100000003000000149f0408
140f00000800000000000000000000000400000000000000c50000000100
0000030000001c9f04081c0f000008000000000000000000000004000000
00000000cc0000000100000003000000249f0408240f0000040000000000
0000000000000400000000000000d10000000600000003000000289f0408
280f0000c800000006000000000000000400000008000000da0000000100
000003000000f09f0408f00f000004000000000000000000000004000000
04000000df0000000100000003000000f49f0408f40f0000240000000000
0000000000000400000004000000e8000000010000000300000018a00408
181000000800000000000000000000000400000000000000ee0000000800
00000300000020a004082010000008000000000000000000000004000000
00000000f3000000010000003000000000000000201000002a0000000000
000000000000010000000100000011000000030000000000000000000000
4a100000fc00000000000000000000000100000000000000010000000200
00000000000000000000f8150000500400001d0000002d00000004000000
1000000009000000030000000000000000000000481a00003f0200000000
000000000000010000000000000000000000000000000000000000000000
000000005481040800000000030001000000000068810408000000000300
02000000000088810408000000000300030000000000ac81040800000000
0300040000000000cc8104080000000003000500000000004c8204080000
00000300060000000000ac820408000000000300070000000000bc820408
000000000300080000000000dc820408000000000300090000000000e482
04080000000003000a0000000000148304080000000003000b0000000000
508304080000000003000c0000000000c08304080000000003000d000000
00009c8604080000000003000e0000000000b88604080000000003000f00
000000001c87040800000000030010000000000058870408000000000300
110000000000149f04080000000003001200000000001c9f040800000000
0300130000000000249f0408000000000300140000000000289f04080000
00000300150000000000f09f0408000000000300160000000000f49f0408
00000000030017000000000018a0040800000000030018000000000020a0
0408000000000300190000000000000000000000000003001a0001000000
00000000000000000400f1ff0c000000149f040800000000010012001a00
00001c9f0408000000000100130028000000249f04080000000001001400
35000000f08304080000000002000d004b00000020a00408010000000100
19005a00000024a004080400000001001900680000005084040800000000
02000d000100000000000000000000000400f1ff74000000189f04080000
000001001200810000004088040800000000010011008f000000249f0408
00000000010014009b000000708604080000000002000d00b10000000000
0000000000000400f1ffc0000000149f04080000000000001200d1000000
289f04080000000001001500da000000149f04080000000000001200ed00
0000f49f0408000000000100170003010000608604080200000012000d00
13010000628604080000000012020d002a01000018a00408000000002000
180035010000748404081801000012000d003c0100000000000000000000
120000004e0100000000000000000000120000006001000020a004080000
00001000f1ff670100009c8604080000000012000e006d01000000000000
00000000120000007f010000209f040800000000110213008c01000018a0
0408000000001000180099010000000000000000000020000000a8010000
000000000000000012000000b80100001ca004080000000011021800c501
0000bc8604080400000011000f00d4010000000000000000000012000000
f1010000f08504086100000012000d000102000028a00408000000001000
f1ff06020000c08304080000000012000d000d020000b886040804000000
11000f001402000020a00408000000001000f1ff200200008c8504085e00
000012000d00250200000000000000000000200000003902000014830408
0000000012000b000063727473747566662e63005f5f43544f525f4c4953
545f5f005f5f44544f525f4c4953545f5f005f5f4a43525f4c4953545f5f
005f5f646f5f676c6f62616c5f64746f72735f61757800636f6d706c6574
65642e363135390064746f725f6964782e36313631006672616d655f6475
6d6d79005f5f43544f525f454e445f5f005f5f4652414d455f454e445f5f
005f5f4a43525f454e445f5f005f5f646f5f676c6f62616c5f63746f7273
5f617578006c6576656c31335f6261636b2e63005f5f696e69745f617272
61795f656e64005f44594e414d4943005f5f696e69745f61727261795f73
74617274005f474c4f42414c5f4f46465345545f5441424c455f005f5f6c
6962635f6373755f66696e69005f5f693638362e6765745f70635f746875
6e6b2e627800646174615f73746172740066745f646573007072696e7466
4040474c4942435f322e30007374726475704040474c4942435f322e3000
5f6564617461005f66696e69006765747569644040474c4942435f322e30
005f5f44544f525f454e445f5f005f5f646174615f7374617274005f5f67
6d6f6e5f73746172745f5f00657869744040474c4942435f322e30005f5f
64736f5f68616e646c65005f494f5f737464696e5f75736564005f5f6c69
62635f73746172745f6d61696e4040474c4942435f322e30005f5f6c6962
635f6373755f696e6974005f656e64005f7374617274005f66705f687700
5f5f6273735f7374617274006d61696e005f4a765f526567697374657243
6c6173736573005f696e697400
